20 20
####################
####....####....####
###.................
####################
##..................
####################
####################
#...................
####################
####################
##################.#
####################
#...................
##################..
##################..
##################..
##################..
##################..
##################..
#################...
############
############


