20 20
####################
####....####....####
###.................
####............####
##..................
####............####
###............#####
#...................
####............####
####............####
####............####
#............#######
#...................
##............######
##............######
####............####
####............####
#####............###
####............####
#################...



